####################
#..................#
#.#...#...#..#...#.#
#.#.#.#.#.#..#.#.#.#
#.#.#...#.....#.#..#
#.#.#.#.#.##.#.#*#.#
#.#.#.#.#..#.#.#.#.#
#...#.....#...#....#
####################

